%%%%%%%%%%%%%%%%%%%%%%%%%%%%%%%%
% % .%.%.G .       %.%.%.  %   %
%   % %.%.  %%     .%%.%.%...%.%
%  .% %.         %%  %%%  ...% %
%.  %  . %.   ..%..  %.  %.%. G%
%.% % %.%.   %%    ..%.%... .% %
% %    ...%.        %%  ....   %
%  .% % %.%. % P        ...%o% %
%  .%    .%%.%%      %.%.o.%.% %
%  %.  %.%.%    . . . .%.%    .%
% % % %.%.  %%     .     %...%.%
% %.%    .%%.%%      %.%.o.%.% %
%%%%%%%%%%%%%%%%%%%%%%%%%%%%%%%%
