%%%%%%%
% . ..%
%.G...%
% . . %
%. .  %
%     %
%  .  %
%   ..%
%P ...%
%%%%%%%
