%%%%%%%%%%%%%%%%%%%%%%
%P  .%..%G   .... .  %
%.  . . %%%.%%.. ..% %
% %    ..    %%% . % %
% %  %..     %..% o  %
% %..%. .    %.o% .% %
%  . %o%% .%.%%% ..  %
% %o %...      ..    %
% % .  %% .%.%%..%   %
% %..% ..    %%.%    %
%  . ....    %..%   G%
%%%%%%%%%%%%%%%%%%%%%%
